######################
#					 #
# Shiny Panda Engine #
#					 #
#    Test Level      #
######################

[level]
version = 1.0.0
tilesetFilePath = tileset.png

[mapReal]
x = 20
y = 10

#raw data
035 035 035 035 035 035 035 035 035 035 035 035 035 035 035 035 035 035 035 035
035 035 035 035 035 035 035 035 035 035 035 035 035 035 035 035 035 035 035 035
035 035 038 009 039 035 035 035 035 035 035 035 035 035 035 035 035 035 035 035
035 035 035 035 035 035 038 039 035 035 035 035 035 035 035 035 035 035 035 035
035 035 035 035 035 035 035 035 035 035 005 006 007 035 035 035 035 035 035 035
008 009 009 009 009 009 009 009 009 009 009 009 010 009 009 009 009 009 009 010
017 035 017 035 035 035 035 035 035 035 035 035 035 035 035 035 035 035 035 035
025 035 025 035 035 035 035 035 035 035 035 035 035 035 035 035 035 035 035 035
017 035 017 035 035 035 035 035 035 035 035 035 035 035 035 035 035 035 035 035
025 035 025 035 035 035 035 035 035 035 035 035 035 035 035 035 035 035 035 035

[mapDream]
x = 4
y = 4

#raw data
035 035 035 035
035 035 035 035
035 001 001 035
001 001 001 001